1111111111
1C001001C1
10010000E1
100P000001
1111111111
