111111111111111111
1C0000000100010011
111111000000100001
111000000000000001
1P0000000011000011
100000011111100E11
111111111111111111
