111111111111111111
1C0000000100C1E011
111111000000100001
111000000000001001
1P0000000011001011
100000C11111111C11
111111111111111111
